ᾱ: GREEK SMALL LETTER ALPHA WITH MACRON
Ᾱ: GREEK CAPITAL LETTER ALPHA WITH MACRON
ᾱ̓: GREEK SMALL LETTER ALPHA WITH MACRON COMBINING COMMA ABOVE
Ᾱ̓: GREEK CAPITAL LETTER ALPHA WITH MACRON COMBINING COMMA ABOVE
ᾱ̔: GREEK SMALL LETTER ALPHA WITH MACRON COMBINING REVERSED COMMA ABOVE
Ᾱ̔: GREEK CAPITAL LETTER ALPHA WITH MACRON COMBINING REVERSED COMMA ABOVE
ᾱ́: GREEK SMALL LETTER ALPHA WITH MACRON COMBINING ACUTE ACCENT
ᾱ̀: GREEK SMALL LETTER ALPHA WITH MACRON COMBINING GRAVE ACCENT

ῑ: GREEK SMALL LETTER IOTA WITH MACRON
Ῑ: GREEK CAPITAL LETTER IOTA WITH MACRON
ῑ̓: GREEK SMALL LETTER IOTA WITH MACRON COMBINING COMMA ABOVE
Ῑ̓: GREEK CAPITAL LETTER IOTA WITH MACRON COMBINING COMMA ABOVE
ῑ̔: GREEK SMALL LETTER IOTA WITH MACRON COMBINING REVERSED COMMA ABOVE
Ῑ̔: GREEK CAPITAL LETTER IOTA WITH MACRON COMBINING REVERSED COMMA ABOVE
ῑ́: GREEK SMALL LETTER IOTA WITH MACRON COMBINING ACUTE ACCENT
ῑ̈: GREEK SMALL LETTER IOTA WITH MACRON COMBINING DIAERESIS

ῡ: GREEK SMALL LETTER UPSILON WITH MACRON
Ῡ: GREEK CAPITAL LETTER UPSILON WITH MACRON
ῡ̔: GREEK SMALL LETTER UPSILON WITH MACRON COMBINING REVERSED COMMA ABOVE
Ῡ̔: GREEK CAPITAL LETTER UPSILON WITH MACRON COMBINING REVERSED COMMA ABOVE
ῡ́: GREEK SMALL LETTER UPSILON WITH MACRON COMBINING ACUTE ACCENT
ῡ̈: GREEK SMALL LETTER UPSILON WITH MACRON COMBINING DIAERESIS

ᾰ: GREEK SMALL LETTER ALPHA WITH VRACHY
Ᾰ: GREEK CAPITAL LETTER ALPHA WITH VRACHY
ᾰ̓: GREEK SMALL LETTER ALPHA WITH VRACHY COMBINING COMMA ABOVE
Ᾰ̓: GREEK CAPITAL LETTER ALPHA WITH VRACHY COMBINING COMMA ABOVE
ᾰ̔: GREEK SMALL LETTER ALPHA WITH VRACHY COMBINING REVERSED COMMA ABOVE
Ᾰ̔: GREEK CAPITAL LETTER ALPHA WITH VRACHY COMBINING REVERSED COMMA ABOVE
ᾰ́: GREEK SMALL LETTER ALPHA WITH VRACHY COMBINING ACUTE ACCENT
ᾰ̀: GREEK SMALL LETTER ALPHA WITH VRACHY COMBINING GRAVE ACCENT

ῐ: GREEK SMALL LETTER IOTA WITH VRACHY
Ῐ: GREEK CAPITAL LETTER IOTA WITH VRACHY
ῐ̓: GREEK SMALL LETTER IOTA WITH VRACHY COMBINING COMMA ABOVE
Ῐ̓: GREEK CAPITAL LETTER IOTA WITH VRACHY COMBINING COMMA ABOVE
ῐ̔: GREEK SMALL LETTER IOTA WITH VRACHY COMBINING REVERSED COMMA ABOVE
Ῐ̔: GREEK CAPITAL LETTER IOTA WITH VRACHY COMBINING REVERSED COMMA ABOVE
ῐ́: GREEK SMALL LETTER IOTA WITH VRACHY COMBINING ACUTE ACCENT
ῐ̀: GREEK SMALL LETTER IOTA WITH VRACHY COMBINING GRAVE ACCENT
ῐ̈: GREEK SMALL LETTER IOTA WITH VRACHY COMBINING DIAERESIS

ῠ: GREEK SMALL LETTER UPSILON WITH VRACHY
Ῠ: GREEK CAPITAL LETTER UPSILON WITH VRACHY
ῠ̓: GREEK SMALL LETTER UPSILON WITH VRACHY COMBINING COMMA ABOVE
ῠ̔: GREEK SMALL LETTER UPSILON WITH VRACHY COMBINING REVERSED COMMA ABOVE
Ῠ̔: GREEK CAPITAL LETTER UPSILON WITH VRACHY COMBINING REVERSED COMMA ABOVE
ῠ́: GREEK SMALL LETTER UPSILON WITH VRACHY COMBINING ACUTE ACCENT
ῠ̀: GREEK SMALL LETTER UPSILON WITH VRACHY COMBINING GRAVE ACCENT
ῠ̈: GREEK SMALL LETTER UPSILON WITH VRACHY COMBINING DIAERESIS
ῠ̒: GREEK SMALL LETTER UPSILON WITH VRACHY COMBINING TURNED COMMA ABOVE
